F1
 0  0  0  0  0  0  0  0  0  0  0  0  0  0  0  0  0  0  0  0
 0  1  1  1  1  1  1  1  1  0  1  1  1  1  1  1  1  1  1  0
 0  0  1  1  1  1  1  1  1  0  1  1  1  1  1  1  0  0  0  0
-1  0  1  1  1  1  1  1  0  0  0  0  1  1  1  1  0  1  1 -1
 8  0  0  0  0  0  1  1  0  1  1  0  1  1  0  0  0  0  0 -1
-1  0  1  1  1  0  0  0  0  0  0  0  0  0  0  1  1  1  0 -1
 0  0  1  1  1  1  1  1  1  0  0  1  1  1  0  1  1  1  0  0
 0  1  1  1  1  1  1  1  0  0  0  0  1  1  0  1  1  1  1  0
 0  0  0  1  1  1  1  0  0  0  0  0  0  1  0  1  1  0  0  0
 1  1  0  0  0  1  0  0  0 -1 -1  0  0  0  0  1  1  0  1  1
 1  1  0  1  0  0  0  0  0 -1 -1  0  0  1  0  0  0  0  1  1
 0  0  0  1  1  1  1  0  0  0  0  0  0  1  1  1  1  0  0  0
 0  1  1  1  1  1  1  1  0  0  0  0  1  1  1  1  1  1  1  0
 0  0  1  1  1  1  1  1  1  0  0  1  1  1  1  1  1  1  0  0
-1  0  1  1  1  0  0  0  0  0  1  0  0  0  0  1  1  1  0 -1
 8  0  0  0  0  0  1  1  1  0  0  0  1  1  0  0  0  0  0 -1
-1  1  0  1  1  1  1  1  0  0  1  0  1  1  1  1  1  1  1 -1
 0  0  0  1  1  1  1  1  0  0  0  0  1  1  1  1  1  1  1  0
 0  1  1  1  1  1  1  1  0  1  1  0  1  1  1  1  1  1  1  0
 0  0  0  0  0  0  0  0  0  0  0  0  0  0  0  0  0  0  0  0
F2
 0  0  0  0  0  0  0  0  0  0  0  0  0  0  0  0  0  0  0  0
 0  1  1  0  1  1  0  1  1  1  0  1  1  1  1  0  1  1  1  0
 0  0  0  0  1  0  0  0  0  1  0  0  0  1  1  0  0  0  0  0
-1  1  1  0  1  0  1  1  0  1  0  1  0  1  1  1  1  1  1 -1
 7  0  0  0  1  0  1  1  0  1  0  1  0  1  0  0  0  0  0  9
-1  0  1  0  1  0  1  1  0  0  0  0  0  0  0  1  1  1  0 -1
 0  0  1  0  0  0  1  1  1  1  0  1  1  1  0  1  1  1  0  0
 0  1  1  1  0  1  1  1  0  0  0  0  1  1  0  1  1  1  1  0
 0  0  0  1  0  1  1  0  0  0  0  0  0  1  0  1  1  0  0  0
 1  1  0  0  0  1  0  0  0 -1 -1  0  0  0  0  0  0  0  1  1
 1  1  0  1  0  0  0  1  0 -1 -1  0  0  1  1  1  1  0  1  1
 0  0  0  1  1  0  1  1  0  0  0  0  0  1  1  1  1  0  0  0
 0  1  1  1  1  0  1  1  1  1  0  0  1  1  1  1  1  1  1  0
 0  0  1  1  1  0  1  1  1  1  0  1  1  1  1  1  1  1  0  0
-1  0  1  1  1  0  0  0  0  0  0  0  0  0  0  1  1  1  0 -1
 7  0  0  0  0  0  1  1  0  1  1  0  1  1  0  0  0  0  0  9
-1  0  1  1  1  1  1  1  0  1  1  0  1  1  0  1  1  1  0 -1
 0  0  1  1  0  0  0  1  0  0  1  0  1  1  0  0  0  0  0  0
 0  1  1  1  0  1  0  1  1  0  1  0  1  1  1  1  1  1  1  0
 0  0  0  0  0  1  0  0  0  0  0  0  0  0  0  0  0  0  0  0
F3
 0  0  0  0  0  0  0  0  0  0  0  0  0  0  0  0  0  0  0  1
 0  1  1  1  0  1  1  1  0  1  0  1  1  1  1  1  1  1  0  1
 0  0  0  0  0  0  0  0  0  1  0  0  0  0  0  0  1  0  0  1
-1  1  1  1  0  1  1  1  0  1  1  0  1  1  1  0  1  0  1 -1
-1  0  0  0  0  0  1  1  0  1  1  0  1  1  0  0  0  0  0  8
-1  0  1  1  1  0  0  0  0  0  0  0  0  0  0  1  1  1  0 -1
 0  0  0  1  1  0  1  1  1  1  0  1  1  1  0  0  1  1  0  0
 0  1  0  0  0  0  1  1  1  1  0  1  1  1  1  0  1  1  1  0
 0  0  0  1  1  1  1  1  1  0  0  1  1  1  1  0  1  0  0  0
 1  1  0  0  0  1  0  0  0  0  0  0  0  1  1  0  0  0  1  1
 1  1  0  1  0  0  0  1  1  0  0  0  0  0  0  0  0  0  1  1
 0  0  0  1  1  0  1  1  1  0  0  0  0  1  1  1  1  0  0  0
 0  1  1  1  1  0  0  1  1  1  0  0  1  1  1  1  1  1  1  0
 0  0  1  1  1  1  0  1  1  1  0  1  1  1  1  1  1  1  0  0
-1  0  1  1  1  0  0  0  0  1  0  0  0  0  0  1  1  1  0 -1
-1  0  0  0  0  0  1  1  0  1  1  0  1  1  0  0  0  0  0  8
-1  1  1  1  0  1  1  1  0  1  1  0  1  1  1  1  1  1  0 -1
 0  0  0  0  0  1  1  1  0  0  0  0  0  1  0  0  0  0  0  1
 0  1  1  1  0  1  1  1  1  1  1  1  0  1  0  1  0  1  1  1
 0  0  0  0  0  0  0  0  0  0  0  0  0  0  0  0  0  1  1  1
