F1
 1  0  0  0  0  0  0  0  0  1  1  1  1  1  1  1  1  1  1  1
 0  0  1  0  1  1  1  1  0  0  0  1  0  0  0  1  0  0  0  0
 0  1  1  0  0  1  1  1  1  1  0  1  0  1  0  0  0  1  1  0
 0  1  1  1  0  0  0  0  0  0  0  0  0  1  1  1  0  1  1  0
 0  0  0  0  0  1 -1 -1 -1 -1 -1  0 -1 -1 -1 -1 -1  0  1  0
 1  1  1  1  0  0 -1  0  0  0  0  0  0  0  0  0 -1  0  0  0
 1  1  1  0  1  1 -1  0 -1  1  1  1  1  1  1  0 -1  1  1  0
 1  0  0  0  0  0 -1  8 -1  0  0  0  0  0  0  0 -1  0  0  0
 1  0  1  1  0  1 -1 -1 -1  1  0  1  1  1  1  0 -1  1  0  1
 1  0  1  0  0  0  0  0  0  0  0  1  1  0  0  0  0  0  0  0
 1  0  1  0  1  1 -1  0  1  1  0  1  1  0 -1 -1 -1  1  1  0
 0  0  0  0  1  1 -1  0  1  1  0  1  1  0 -1  8 -1  0  0  0
 0  1  1  0  0  1 -1  0  1  1  0  1  1  0 -1  0 -1  0  1  0
 0  1  1  1  0  0 -1  0  0  0  0  0  0  0  0  0 -1  0  1  0
 0  0  0  0  0  1 -1 -1 -1 -1 -1  0 -1 -1 -1 -1 -1  0  1  0
 1  1  1  0  0  0  0  1  0  0  0  0  0  1  0  0  0  0  0  0
 1  1  0  0  1  1  0  0  0  1  0  1  1  1  0  1  1  0  0  0
 0  0  0  1  0  0  0  1  0  1  0  0  0  0  0  0  0  0  0  0
 0  0  0  0  0  1  0  1  0  1  0  1  1  1  1  0  0  1  0  1
 1  0  1  1  0  0  0  1  0  0  0  0  0  0  0  0  0  0  0  0
F2
-1 -1 -1 -1 -1 -1 -1 -1 -1 -1 -1 -1 -1 -1 -1 -1 -1 -1 -1 -1
-1 -1 -1 -1 -1 -1 -1 -1 -1 -1 -1 -1 -1 -1 -1 -1 -1 -1 -1 -1
-1 -1 -1 -1 -1 -1 -1 -1 -1 -1 -1 -1 -1 -1 -1 -1 -1 -1 -1 -1
-1 -1 -1 -1 -1 -1 -1 -1 -1 -1 -1 -1 -1 -1 -1 -1 -1 -1 -1 -1
-1 -1 -1 -1 -1 -1 -1 -1 -1 -1 -1  9 -1 -1 -1 -1 -1 -1 -1 -1
-1 -1 -1 -1 -1 -1 -1  0  0  0  1  0  1  0  0  0 -1 -1 -1 -1
-1 -1 -1 -1 -1 -1 -1  0 -1  0  1  0  1  0 -1  0 -1 -1 -1 -1
-1 -1 -1 -1 -1 -1 -1  9 -1  0  0  0  0  0 -1  7 -1 -1 -1 -1
-1 -1 -1 -1 -1 -1 -1 -1 -1  1  0  1  1  1 -1 -1 -1 -1 -1 -1
-1 -1 -1 -1 -1 -1  9  0  0  0  0  1  1  0  0  0  9 -1 -1 -1
-1 -1 -1 -1 -1 -1 -1 -1 -1  1  0  1  1  0 -1 -1 -1 -1 -1 -1
-1 -1 -1 -1 -1 -1 -1  7 -1  1  0  0  1  0 -1  9 -1 -1 -1 -1
-1 -1 -1 -1 -1 -1 -1  0 -1  1  1  0  1  0 -1  0 -1 -1 -1 -1
-1 -1 -1 -1 -1 -1 -1  0  0  0  0  0  0  0  0  0 -1 -1 -1 -1
-1 -1 -1 -1 -1 -1 -1 -1 -1 -1 -1  9 -1 -1 -1 -1 -1 -1 -1 -1
-1 -1 -1 -1 -1 -1 -1 -1 -1 -1 -1 -1 -1 -1 -1 -1 -1 -1 -1 -1
-1 -1 -1 -1 -1 -1 -1 -1 -1 -1 -1 -1 -1 -1 -1 -1 -1 -1 -1 -1
-1 -1 -1 -1 -1 -1 -1 -1 -1 -1 -1 -1 -1 -1 -1 -1 -1 -1 -1 -1
-1 -1 -1 -1 -1 -1 -1 -1 -1 -1 -1 -1 -1 -1 -1 -1 -1 -1 -1 -1
-1 -1 -1 -1 -1 -1 -1 -1 -1 -1 -1 -1 -1 -1 -1 -1 -1 -1 -1 -1
F3
-1 -1 -1 -1 -1 -1 -1 -1 -1 -1 -1 -1 -1 -1 -1 -1 -1 -1 -1 -1
-1 -1 -1 -1 -1 -1 -1 -1 -1 -1 -1 -1 -1 -1 -1 -1 -1 -1 -1 -1
-1 -1 -1 -1 -1 -1 -1 -1 -1 -1 -1 -1 -1 -1 -1 -1 -1 -1 -1 -1
-1 -1 -1 -1 -1 -1 -1 -1 -1 -1 -1 -1 -1 -1 -1 -1 -1 -1 -1 -1
-1 -1 -1 -1 -1 -1 -1 -1 -1 -1 -1  9 -1 -1 -1 -1 -1 -1 -1 -1
-1 -1 -1 -1 -1 -1 -1  0  0  0  0  0  0  0  0  0 -1 -1 -1 -1
-1 -1 -1 -1 -1 -1 -1  0  1  1  0  1  1  0 -1  0 -1 -1 -1 -1
-1 -1 -1 -1 -1 -1 -1  0  1  0  0  0  0  0 -1  8 -1 -1 -1 -1
-1 -1 -1 -1 -1 -1 -1  0  1  0  1  1  1  0 -1 -1 -1 -1 -1 -1
-1 -1 -1 -1 -1 -1  9  0  0  0  0  1  1  0  0  0  9 -1 -1 -1
-1 -1 -1 -1 -1 -1 -1 -1 -1  1  0  1  1  1  1  0 -1 -1 -1 -1
-1 -1 -1 -1 -1 -1 -1  8 -1  0  0  0  0  0  1  0 -1 -1 -1 -1
-1 -1 -1 -1 -1 -1 -1  0 -1  0  1  1  1  0  1  0 -1 -1 -1 -1
-1 -1 -1 -1 -1 -1 -1  0  0  0  0  0  0  0  0  0 -1 -1 -1 -1
-1 -1 -1 -1 -1 -1 -1 -1 -1 -1 -1  9 -1 -1 -1 -1 -1 -1 -1 -1
-1 -1 -1 -1 -1 -1 -1 -1 -1 -1 -1 -1 -1 -1 -1 -1 -1 -1 -1 -1
-1 -1 -1 -1 -1 -1 -1 -1 -1 -1 -1 -1 -1 -1 -1 -1 -1 -1 -1 -1
-1 -1 -1 -1 -1 -1 -1 -1 -1 -1 -1 -1 -1 -1 -1 -1 -1 -1 -1 -1
-1 -1 -1 -1 -1 -1 -1 -1 -1 -1 -1 -1 -1 -1 -1 -1 -1 -1 -1 -1
-1 -1 -1 -1 -1 -1 -1 -1 -1 -1 -1 -1 -1 -1 -1 -1 -1 -1 -1 -1

